111111111
100000001
111001001
100001001
111111111
